{
    "adjadency": [
        ["a", "b", 700],
        ["a", "j", 1300],

        ["b", "a", 700],
        ["b", "d", 600],
        ["b", "c", 400],
        ["b", "j", 1400],

        ["c", "d", 300],
        ["c", "i", 750],
        ["c", "b", 400],

        ["d", "e", 700],
        ["d", "c", 300],
        ["d", "b", 600],
        ["d", "h", 900],

        ["e", "h", 250],
        ["e", "d", 700],
        ["h", "e", 250],
        ["e", "g", 650],

        ["f", "h", 350],

        ["g", "h", 340],
        ["g", "e", 650],
        ["g", "j", 1800],

        ["h", "f", 350],
        ["h", "g", 340],
        ["h", "d", 900],

        ["i", "c", 750],
        ["i", "j", 300],

        ["j", "g", 1800],
        ["j", "a", 1300],
        ["j", "b", 1400],
        ["j", "i", 300]
    ],
    "countries": {
        "Russian Federation": ["a", "b", "c", "d"],
        "United Kinngdom": ["e", "f", "g", "h"],
        "China": ["i", "j"]
    }
}
